111111111111111
1000100000000C1
100000111110001
10P0011E0000001
111111111111111